1111111111____________________________________________________11
1111111111____________________________________________________11
1111111111____________________________________________________11
111111111_____________________________________________________11
111111________________________________________________________11
11____________________________________________________________11
11____________________________________________________________11
11____________________________________________________________11
11____________________________________________________________11
11____________________________________________________________11
11____________________________________________________________11
11____________________________________________________________11
11____________________________________________________________11
11____________________________________________________________11
11____________________________________________________________11
11____________________________________________________________11
11____________________________________________________________11
11____________________________________________________________11
11____________________________________________________________11
11____________________________________________________________11
11____________________________________________________________11
11____________________________________________________________11
11____________________________________________________________11
11____________________________________________________________11
11____________________________________________________________11
11____________________________________________________________11
11____________________________________________________________11
11____________________________________________________________11
11____________________________________________________________11
11____________________________________________________________11
11____________________________________________________________11
11____________________________________________________________11
11____________________________________________________________11
11____________________________________________________________11
11____________________________________________________________11
1111111111111111111111111111111111111111111111111111111111111111