sssssssssssssssssssssssssssssssssssssssssssd____________________
sssssssssssgxxxxxxxxxxxxxxfgxxxxxxxxxxxxxxxc____________________
xxxxxxxxxxfd______________ad____________________________________
__________ad______________ad____________________________________
__________ad______________ad____________________________________
__________ad______________ad____________________________________
__________ad______________ad____________________________________
__________ad______________ad____________________________________
__________ad____ad________ad____________________________________
__________ad____ad________ad____________________________________
__________ad____ad________ad____________________________________
__________ad____ad________ad____________________________________
__________ad____ad________ad____________________________________
__________ad____ad________ad______________________________ad____
__________ad____ad________________________________________ad____
__________ad____ad______________________________________________
__________ad____ad______________________________________________
__________ad____ad______________________________________________
__________ad____ad______________________________________________
__________ad____ad______________________________________________
__________ad____ad______________________________________________
__________ad____ad________ad____________________________________
__________zc____ad________ad____________________________________
________________ad________ad____________________________________
________________ad________ad____________________________________
________________ad________ad____qwwwwwwwwwwe__________qwwwwwwwww
________________ad________ad____assssssssssd__________asssssssss
________________ad________ad____assssssssssd__________asssssssss
________________ad________ad____assssssssssd__________asssssssss
________________ad________ad____assssssssssd__________asssssssss
wwwwwwwwwwwe____ad________ad____assssssssssd__________asssssssss
sssssssssssd____ad________ad____assssssssssd__________asssssssss
sssssssssssd____ad________ad____assssssssssd__________asssssssss
sssssssssssd____ad________ad____assssssssssd__________asssssssss
sssssssssssd____ad________ad____assssssssssd__________asssssssss
sssssssssssssssssssssssssssssssssssssssssssd__________asssssssss