1111__________________________________________________1111111111
1111__________________________________________________1111111111
1111__________________________________________________1111111111
111111111111__________________________________________1111111111
!!!!__________________________________________________1111111111
!!!!__________________________________________________1111111111
!!!!__________________________________________________1111111111
!!!!__________________________________________________1111111111
!!!!__________________________________________________1111111111
!!!!__________________________________________________!!!!!!!!!!
!!!!__________________________________________________!!!!!!!!!!
1111__________________________________________________!!!!!!!!!!
!!!1__________________________________________________!!!!!!!!!!
!!!1__________________________________________________!!!!!!!!!!
!!!1__________________________________________________!!!!!!!!!!
!!!!__________________________________________________!!!!!!!!!!
!!!!__________________________________________________!!!!!!!!!!
!!!!__________________________________________________!!!!!!!!!!
!!!!__________________________________________________!!!!!!!!!!
1111__________________________________________________11!!!!!!11
11____________________________________________________1111!!!!11
11____________________________________________________11!!!!!!11
11____________________________________________________11!!!!!!11
11____________________________________________________11!!!!!!11
11____________________________________________________11!!!!!!11
11____________________________________________________11!!!!1111
11____________________________________________________11!!!!!!11
11____________________________________________________11!!!!!!11
11____________________________________________________11!!!!!!11
11____________________________________________________11!!!!!!11
11____________________________________________________1111111111
11____________________________________________________1111111111
11____________________________________________________1111111111
11____________________________________________________1111111111
11____________________________________________________1111111111
11____________________________________________________1111111111