11____________________________________________________1111111111
11____________________________________________________1111111111
11____________________________________________________1111111111
11________________________________________________________111111
11___________________________________________________________111
11___________________________________________________________111
11___________________________________________________________111
11___________________________________________________________111
11____________________________________________________________11
11____________________________________________________________11
11____________________________________________________________11
11____________________________________________________________11
11____________________________________________________________11
11____________________________________________________________11
11____________________________________________________________11
11____________________________________________________________11
11____________________________________________________________11
11____________________________________________________________11
11____________________________________________________________11
11____________________________________________________________11
11____________________________________________________________11
11____________________________________________________________11
11____________________________________________________________11
11____________________________________________________________11
11____________________________________________________________11
11____________________________________________________________11
11____________________________________________________________11
11____________________________________________________________11
11____________________________________________________________11
11____________________________________________________________11
11____________________________________________________________11
11____________________________________________________________11
11____________________________________________________________11
11____________________________________________________________11
11____________________________________________________________11
1111111111111111111111111111111111111111111111111111111111111111