11111111111111111111111111___11111111111111111111111111111111111
11111111111111111111111111___11111111111111111111111111111111111
1______________________________________________________________1
1______________________________________________________________1
1______________________________________________________________1
1______________________________________________________________1
1______________________________________________________________1
1______________________________________________________________1
1______________________________________________________________1
1______________________________________________________________1
1______________________________________________________________1
1______________________________________________________________1
1______________________________________________________________1
1______________________________________________________________1
1______________________________________________________________1
1______________________________________________________________1
1______________________________________________________________1
1______________________________________________________________1
1______________________________________________________________1
1______________________________________________________________1
1______________________________________________________________1
1______________________________________________________________1
1______________________________________________________________1
1______________________________________________________________1
1______________________________________________________________1
1______________________________________________________________1
1______________________________________________________________1
1______________________________________________________________1
1______________________________________________________________1
1______________________________________________________________1
1______________________________________________________________1
1______________________________________________________________1
111__11bbbbbbbbbbbbbbbbbbbbbbbbbbbbbbbbbbbbbbbbbbbbbbbbbb11__111
1111111__________________________________________________1111111
1LLLLLLLLLLLLLLLLLLLLLLLLLLLLLLLLLLLLLLLLLLLLLLLLLLLLLLLLLLLLLL1
1llllllllllllllllllllllllllllllllllllllllllllllllllllllllllllll1