111111111FF111111111111111______________111111111111111111111111
1__111111FF1_____________1______________1111111111______________
1________FF1_____________1______________1111111111______________
1________FF1____11111____1______________1111111111______________
1________111____11111____1______________1111111111______________
1__________1____11111____1______________1111111111________111111
1__________1____1111111111______________1111111111______________
1__________1____1111111111______________1111111111______________
1__________1____1111111111______________1111111111______________
1111111____1____1111111111______________1111111111______________
11111______1____1111111111______________1111111111______________
11111______1____1111111111______________1111111111______________
11111______1____1111111111______________1111111111G_____________
11111______1____1111111111______________1_________G_____________
1111_______1____1111111111______________1_________G_____________
1111______11____1111111111______________1____11111G_____________
111_______11____1111111111______________1____11111G_____________
111______111____1111111111______________1____11111G_____________
111______111____1111111111111111111111111111111111G_____________
111______111______________________________________________111111
11_______111______________________________________________111111
11______1111____________________________________________________
1_______1111____________________________________________________
1______111111111111111111111111111111111111111111111111111111111
1______11_________________________________________________111111
1_________________________________________________________111111
1___________________________________________________________1111
1___________________________________________________________1111
1_____________________________________________________________11
1_____________________________________________________________11
1_______________________________________________________________
1_______________________________________________________________
1_______________________________________________________________
1______11_______________________________________________________
1______11_______________________________________________________
1111111111111111111111111111111111111111111111111111111111111111