11111D111111111111111111111111111111111111111111111111D111111111
!!!!!!!!!!!!!!!!!!!!!!!!!!!!!!!!!!!!!!!!!!!!!!!!!!!!!!!!!!!!!!!!
!!!!!!!!!!!!!!!!!!!!!!!!!!!!!!!!!!!!!!!!!!!!!!!!!!!!!!!!!!!!!!!!
!!!!!!!!!!!!!!!!!!!!!!!!!!!!!!!!!!!!!!!!!!!!!!!!!!!!!!!!!!!!!!!!
!!!!!!!!!!!!!!!!!!!!!!!!!!!!!!!!!!!!!!!!!!!!!!!!!!!!!!!!!!!!!!!!
!!!!!!!!!!!!!!!!!!!!!!!!!!!!!!!!!!!!!!!!!!!!!!!!!!!!!!!!!!!!!!!!
!!!!!!!!!!!!!!!!!!!!!!!!!!!!!!!!!!!!!!!!!!!!!!!!!!!!!!!!!!!!!!!!
!!!!!!!!!!!!!!!!!!!!!!!!!!!!!!!!!!!!!!!!!!!!!!!!!!!!!!!!!!!!!!!!
!!!!!!!!!!!!!!!!!!!!!!!!!!!!!!!!!!!!!!!!!!!!!!!!!!!!!!!!!!!!!!!!
11111DbbbbbbbbbbbbbbbbbbbbbbbbbbbbbbbbbbbbbbbbbbbbbbbbD111111111
111111________________________________________________1111111111
1111__________________________________________________1111111111
1111__________________________________________________1111111111
1111__________________________________________________1111111111
1111__________________________________________________1111111111
1111__________________________________________________1111111111
1111__________________________________________________1111111111
1111__________________________________________________1111111111
1111__________________________________________________1111111111
1111__________________________________________________1111111111
1111__________________________________________________1111111111
1111__________________________________________________1111111111
1111__________________________________________________1111111111
1111__________________________________________________1111111111
1111__________________________________________________1111111111
1111__________________________________________________1111111111
1111__________________________________________________1111111111
1111__________________________________________________1111111111
1111__________________________________________________1111111111
1111__________________________________________________1111111111
1111__________________________________________________1111111111
1111__________________________________________________1111111111
1111__________________________________________________1111111111
1111__________________________________________________1111111111
1111__________________________________________________1111111111
1111__________________________________________________1111111111