11!!!!!!11____________________________________________________!!
11!!!!!!11____________________________________________________!!
11!!!!!!11____________________________________________________!!
11!!!!!!11____________________________________________________!!
11!!!!!!!!____________________________________________________!!
11!!!!!!!!____________________________________________________!!
11!!!!!!!!____________________________________________________!!
11!!!!!!!!____________________________________________________!!
11!!!!!!!!____________________________________________________!!
11!!!!!!!!____________________________________________________!!
11!!!!!!!!__________________________11________________________!!
11!!!!!!!!____________________________________________________11
11!!!!!!!!____________________________________________________!!
11!!!!!!!!____________________________________________________!!
11!!!!!!!!____________________________________________________!!
11!!!!!!!!____________________________________________________!!
11!!!!!!!!____________________________________________________!!
11!!!!!!!!____________________________________________________!!
11!!!!!!!!__________________________11________________________!!
11!!!!!!!!____________________________________________________11
11!!!!!!11____________________________________________________11
11!!!!1111____________________________________________________11
11!!!!!!11____________________________________________________11
11!!!!!!11____________________________________________________11
11!!!!!!11____________________________________________________11
11!!!!!!11____________________________________________________11
1111!!!!11____________________________________________________11
11!!!!!!11____________________________________________________11
11!!!!!!11____________________________________________________11
11!!!!!!11____________________________________________________11
11!!!!!!11____________________________________________________11
1111111111____________________________________________________11
1111111111____________________________________________________11
1111111111____________________________________________________11
1111111111____________________________________________________11
1111111111____________________________________________________11