1111111111111111111111111111111111111111111111111111111111111111
______11________________________________________________11______
______11________________________________________________11______
______11________________________________________________11____11
______11________________________________________________11____11
11____________________________________________________________11
11__________________________________________________________1111
11__________________________________________________________1111
11__________________________________________________________1111
11__________________________________________________________1111
11111111________________________________________________11111111
11111111________________________________________________11111111
11111111________________________________________________11111111
11111111________________________________________________11111111
1111111111111111111111111111111111111111111111111111111111111111
________________________________________________________11111111
________________________________________________________11111111
________________________________________________________11111111
________________________________________________________11111111
11111111________________________________________________11111111
11111111________________________________________________11111111
11111111________________________________________________11111111
11111111________________________________________________11111111
1111111D________________________________________________D1111111
11_____________________________________________________________1
11_____________________________________________________________1
11_____________________________________________________________1
11_____________________________________________________________1
11_____________________________________________________________1 
11_____________________________________________________________1
_______________________________________________________________1
_______________________________________________________________1
____111DbbbbbbbbbbbbbbbbbbbbbbbbbbbbbbbbbbbbbbbbbbbbbbbbD1111111
____1111________________________________________________11111111
____1111LLLLLLLLLLLLLLLLLLLLLLLLLLLLLLLLLLLLLLLLLLLLLLLL11111111
11111111llllllllllllllllllllllllllllllllllllllllllllllll11111111