2222222222222222222222222222222222222222222222222222222222222222
2____________________________________2________22_______________2
2____________________________________2________22_______________2
2____________________________________2________22_______________2
2____________________________________2________22_______________2
2____________________________________2________2222222222_______2
2____________________________________2________22222222_________2
2____________________________________2________22_____________222
2____________________________________2____22_______________22222
2____________________________________2____22_____________2222222
2____________________________________2____22___________222222222
2____________________________________2____22_________22222222222
2____________________________________2____22_______2222222222222
2____________________________________2____22_____222222222222222
2____________________________________2____22___22222222222222222
2____________________________________2____22___________________2
2____________________________________2____22___________________2
2____________________________________2____22___________________2
22222222222222222222222222222222222222_________________________2
2____________________________________2_________________________2
2____________________________________2_________________________2
2____________________________________2_________________________2
2____________________________________2_________________________2
22222222222222222222222222222222222222_________________________2
2____________________________________2_________2222222222______2
2____________________________________2______2222_______________2
2____________________________________2___2222222_______________2
2____________________________________22222222222_______________2
2____________________________________2_________________________2
2____________________________________2_________________________2
2______________________22____________2_________________________2
2______________________22____________0_________________________2
2______________________22____________0_________________22______2
2______________________22____________0_________________22______2
2_____________22_______22____________0_________________22______2
2222222222222222222222222222222222222222222222222222222222222222