11!!!!!!11____________________________________________1!!!!!!!!!
11!!!!!!11____________________________________________1!!!!!!!!!
11!!!!!!11____________________________________________1!!!!!!!!!
11!!!!!!11____________________________________________1!!!!!!!!!
11!!!!!!11____________________________________________1!!!!!!!!!
11!!!!!!11____________________________________________1!!!!!!!!!
11!!!!!!11____________________________________________1!!!!!!!!!
11!!!!!!11____________________________________________1!!!!!!!!!
11!!!!!!11____________________________________________1!!!!!!!!!
11!!!!!!11____________________________________________1111111111
11!!!!!!11____________________________________________________!!
11!!!!!!11____________________________________________________!!
11!!!!!!11____________________________________________________!!
11!!!!!!11____________________________________________________!!
11!!!!!!11____________________________________________________!!
11!!!!!!11____________________________________________________!!
11!!!!!!11____________________________________________________!!
11!!!!!!11____________________________________________________!!
11!!!!!!11____________________________________________________!!
11!!!!!!11____________________________________________________!!
11!!!!!!11____________________________________________________!!
11!!!!!!11____________________________________________________!!
11!!!!!!11____________________________________________________!!
11!!!!!!11____________________________________________________!!
11!!!!!!11____________________________________________________!!
11!!!!!!11____________________________________________________!!
11!!!!!!11____________________________________________________!!
11!!!!!!11__________________11111111111111111_________________!!
11!!!!!!11____________________________________________________!!
11!!!!!!11____________________________________________________!!
11!!!!!!11____________________________________________________!!
11!!!!!!11____________________________________________________!!
11!!!!!!11____________________________________________________!!
11!!!!!!11____________________________________________________!!
11!!!!!!11____________________________________________________!!
11!!!!!!11____________________________________________________!!