1111111111111111111111111111111111111111111111111111111111111111
!!!!!!!!!!!!!!!!!!!!!!!!!!!!!!!!!!!!!!!!!!!!!!!!!!!!!!!!!!!!!!!!
!!!!!!!!!!!!!!!!!!!!!!!!!!!!!!!!!!!!!!!!!!!!!!!!!!!!!!!!!!!!!!!!
!!!!!!!!!!!!!!!!!!!!!!!!!!!!!!!!!!!!!!!!!!!!!!!!!!!!!!!!!!!!!!!!
!!!!!!!!!!!!!!!!!!!!!!!!!!!!!!!!!!!!!!!!!!!!!!!!!!!!!!!!!!!!!!!!
!!!!!!!!!!!!!!!!!!!!!!!!!!!!!!!!!!!!!!!!!!!!!!!!!!!!!!!!!!!!!!!!
!!!!!!!!!!!!!!!!!!!!!!!!!!!!!!!!!!!!!!!!!!!!!!!!!!!!!!!!!!!!!!!!
!!!!!!!!!!!!!!!!!!!!!!!!!!!!!!!!!!!!!!!!!!!!!!!!!!!!!!!!!!!!!!!!
!!!!!!!!!!!!!!!!!!!!!!!!!!!!!!!!!!!!!!!!!!!!!!!!!!!!!!!!!!!!!!!!
11111111111!!!!11!!11!!11!!11!!11!!11!!11!!11!!11!!!!!!!!!!!!!11
11111111111!!!!11!!11!!11!!11!!11!!11!!11!!11!!11!!!!!!!!!!!!!11
11_______________________________________________!!!!!!!!!!!!!11
11_______________________________________________!!!!!!!!!!!!!11
11_______________________________________________!!!!!!!!!!!!!11
11_______________________________________________!!!!!!!!!!!!!11
11____________________________________________________________11
11____________________________________________________________11
11____________________________________________________________11
11____________________________________________________________11
11____________________________________________________________11
11____________________________________________________________11
11____________________________________________________________11
11____________________________________________________________11
11____________________________________________________________11
11____________________________________________________________11
11____________________________________________________________11
11____________________________________________________________11
11____________________________________________________________11
11____________________________________________________________11
11____________________________________________________________11
11____________________________________________________________11
11____________________________________________________________11
11____________________________________________________________11
11____________________________________________________________11
11____________________________________________________________11
11____________________________________________________________11