9001 0 0
16 150 550 500 100 1.3 1
16 320 500 500 150 1.3 1
16 490 450 500 200 1.3 1
16 660 400 500 250 1.3 1
16 880 280 1150 40 5.26 1