1111111111111111111111111111111111111111111111111111111111111111
_______________________________________________________________1
_______________________________________________________________1
11_____________________________________________________________1
11_____________________________________________________________1
11________________________________________________________11___1
11________________________________________________________11___1
11________________________________________________________11___1
11________________________________________________________11___1
11________________________________________________________11___1
11________________________________________________________11___1
11________________________________________________________11___1
11________________________________________________________11___1
11________________________________________________________11___1
11________________________________________________________11___1
111111111111111111111111111111111111111111111111111111111111___1
1______________________________________________________________1
1______________________________________________________________1
1______________________________________________________________1
1______________________________________________________________1
1______________________________________________________________1
1______________________________________________________________1
1______111111111111111111111111111111111111111111111111111111111
1______1___1___________________________________________________1
1______1___1___________________________________________________1
1______1___1___________________________________________________1
1______________________________________________________________1
1______________________________________________________________1
1______________________________________________________________1
1______________________________________________________________1
11111111111111111111111111111111yy111111111111111111111111111111
111111111111111111111111111111yyyyyy1111111111111111111111111111
11111111111111111111111111yyyyyyyyyyyyyy1___11111111111111111111
11111111111111111111111111__________________11111111111111111111
11111111111111111111111111__________________11111111111111111111
11111111111111111111111111___11111111111111111111111111111111111